%%%%%%%%%%%%%%%%%%%%%%%%%%%%%%%%%%%%%%%%%%%%%%%
%       % % %           %   %     %          P%
% %%%%%%% % %%% % %%% %%% %%%%%%% %           %
%       %       % %     %     % %             %
%%%%% %%%%% %%% % % % %%% %%%%% % %%          %
%   % % % %   % % % %   % %   % %             %
% %%% % % % %%% %%%%% %%% % %%% %%%           %
%       %     %   %   %     % % %             %
%%% %%%%%%%%% %%%%%%% %%% %%% % % % %         %
%             %       % %   %     % %         %
% % %%%%% % %%% % % %%% % %%% %%% %           %
% % %     % % % % %     %   % % % % %         %
% % % %%%%%%% % %%%%%%%%% %%% % %%%           %
% % % %     %   %     %     %   %             %
%%% %%% % %%%%% %%%%% %%% %%% %%%%% %         %
%     % % %     % %     % %   % % % %         %
% % % % % %%% %%% %%% %%% % % % % % %         %
% % % % %                 % % %     %         %
%%% %%%%%%% % % %%%%% %%% % %%% %%%%%         %
%       % % % %     %   %     % %             %
%%%%% % % %%%%%%%%% %%%%%%%%%%% % %%%         %
%   % %           % %     %   % %   %         %
% %%% %%%%% %%%%%%%%% %%%%% % % %%% %         %
% %   %      %        %     %       %         %
% % % %%%%% %%% % % % % %%%%%%%%%%%%%         %
% % %   %     % % % %       %   % %           %
% % %%% %%% % % % %%%%%%%%% %%% % %           %
% %   % %   % % %   % %   % % %               %
% %%% %%% %%%%% %%% % % %%%%% % %%%%          %
%       %   %     % %     %   % %             %
%%% % %%%%% %%%%% %%% %%% % %%% % %%          %
% % % % % % % %     % %   % %   % %           %
% % %%% % % % % %%%%%%%%% % % % % %           %
%   %   %   %                 %     %         %
% % % % %%% %%% %%%%%%% %%% %%% %%% %         %
% % % %       %   %       %   % %             %
% %           %   %       %   % %             %
% % % %       %   %       %   % %             %
% % % %       %   %       %   % %             %
% % % %%%%%%%%%   %       %   % %             %
% % % %       %   %       %   % %             %
% % % %       %   %       %   % %             %
% % % %       %   %       %   % %             %
% % % %       %   %       %   % %             %
% % % %       %   %       %   % %             %
%.% % %       %   %       %   % %             %
%%%%%%%%%%%%%%%%%%%%%%%%%%%%%%%%%%%%%%%%%%%%%%%