%%%%%%%%%%%%%%%%%%%%%%
%P%%        % %      %
%    %%%%%% % %%%%%% %
%%%% %      % %      %
%    %%%%%%%% %% %%%%%
%%%%%% %         %   %
%        %%% %%%   % %
%%%%%%% %%  % %%%%%% %
%.         %%        %
%%%%%%%%%%%%%%%%%%%%%%