%%%%%%%%%%%%%%%%%%%%%%
%           %        %
%   %    %  %  %%%%%%%
% %%%  %%%  %    %   %
%   %     %%%   P    %
%    %%%%   %%%%%%   %
%%%%    %%%      %   %
%   %%%   %%%%%  %   %
%.      %     %      %
%%%%%%%%%%%%%%%%%%%%%%