%%%%%%%%%%%%%%%%%%%%%%
% % % % % % % % % % P%
%                    %
% % % % % % % % % %  %
%                    %
% % % % % % % % % %  %
%                    %
% % % % % % % % % %  %
%.                   %
%%%%%%%%%%%%%%%%%%%%%%