%%%%%%%%%%%%%%%%%%%%%%
%P     %       %     %
% % %    % %%%%%  %%%%
%%% %  %%%     %     %
%   %  %         % %%%
% % %%  %%%    %     %
% %     % %  %%  %%  %
%%%%% %%  %   %  %   %
%.                %  %
%%%%%%%%%%%%%%%%%%%%%%