%%%%%%%%%%%%%%%%%%%%%%
%       %   %       P%
%   %       %  %%%%%%%
%   %       %    %   %
%   %%%%%   %        %
%       %   %%%%%    %
%%%%%   %            %
%       %     %      %
%.  %   %     %      %
%%%%%%%%%%%%%%%%%%%%%%