%%%%%%%%%%%%%%%%%%%%%%
%P    %     %   % %  %
%%%%     %%%  %%% %  %
%  %  %              %
%     %%%%           %
%%%%%%%              %
%      %%%           %
%                    %
%.                   %
%%%%%%%%%%%%%%%%%%%%%%