%%%%%%%%%%%%%%%%%%%%%%
%   %       %       P%
%   %       %  %%%%%%%
%   %       %        %
%   %   %   %        %
%       %   %        %
%       %            %
%       %            %
%.      %            %
%%%%%%%%%%%%%%%%%%%%%%