%%%%%%%%%%%%%%%%%%%%%%
%     %%            P%
% %% %   %%%%% %%%%% %
% %%   %%%%       %% %
% %%%%%%     %%% %%% %
%  %%%%   %%%%%      %
%%     %     %%%   %%%
%%%%%   %%%   %%% %%%%
%.           %%%     %
%%%%%%%%%%%%%%%%%%%%%%