%%%%%%%%%%%%%%%%%%%%%%
%                   P%
%                    %
%                    %
%                    %
%                    %
%                    %
%                    %
%.                   %
%%%%%%%%%%%%%%%%%%%%%%