%%%%%%%%%%%%%%%%%%%%%%
%P    %     %     %  %
%%%%     %%   %%% %  %
%  %  %     %%       %
%     %%%%%%   %%%%  %
%%%%%%       %    %  %
%      %%% % %%%%%% %%
%%%%% %    %    %    %
%.      % %%% %    %%%
%%%%%%%%%%%%%%%%%%%%%%