%%%%%%%%%%%%%%%%%%%%%%
%    %               %
% %%  %%  %%%%%%%%%  %
%   %  %  %          %
%%  %     %  %%%%%%%%%
%P %%%%%%%%          %
% %     %%%%%%%%%%%  %
%%%%% %     %    %%  %
%.     %  %    %     %
%%%%%%%%%%%%%%%%%%%%%%