%%%%%%%
%     %
% %%% %
%  %  %
%% % %%
%. % P%
%%%%%%%
